# # # # # # # # # #
#   #       #     #
#   #   #   #     #
#   #   #   #     #
#       # # #   # #
#       #       # #
#   # # #   #      
#   # # # # # #   #
#                 #
# # # # # # # # # # 