# # # # # # # # # #
#   #       #     #
#   #   #   #     #
#   #   #   #     #
#       # # #   # #
#       # # #   # #
#   #       #     #
#   # # # # # #   #
#                 #
# #   # # # # # # # 