# # # # # # # # # #
#   #       #     #
#   #       #     #
#   # #   # # #   #
#                 #
#   #   #   #     #
# # #   #   #      
#   #   # # # #   #
#                 #
# # # # # # # # # # 