# # # # # # # # # #
#   # # #   #      
#   #   #   #     #
#   #   #   #   # #
#                 #
#   # # #   #   # #
#           #   # #
#   # # # # # # # #
#               # #
# # # # # # # # # # 