# # # # # # # # # #
        #   # # # #
#   #             #
# # # # #   #     #
#       #   #     #
#   # # #   # # # #
#       #     #   #
#   # # #   # #   #
#                 #
# # # # # # # # # # 